flat : space place 
wide : space hall mouth lake dead 
open : space mouth field gallery 
little : space help one feast dog water piece history bird child people rain picture lantern drop band nut stick bell fat gold toad roll gray girl snail street bunch dead pride mouse stool 
small : space piece shirt ship company table nut pair 
great : help hall one cloth feast dog water force piece power history ship lake day bird chill gap company number field battle table king mantle toad fault bunch pride 
large : hall dog piece ship lake bird company number yellow heavy bowl picture building table band harp iron cross roll gray copper 
fair : one place day company vision number 
single : one day drop form word fault 
new : one people mind sense pair bell castle 
fresh : one piece 
young : one child girl maiden 
white : cloth ship stick cross 
black : cloth mouth knife heavy battle form 
good : job exchange child stretch bowl word few fat 
nasty : job cold 
poor : exchange child woman tub street maiden 
mighty : growth oak storm magician 
deep : growth place bowl 
thick : growth line drizzle gold 
enormous : oak number 
low : place pier stool 
strong : place water force hand 
merry : feast face 
long : line high day thread knife yellow heavy journey mantle gallery 
tall : line ship gap trunk 
whole : line lake day people hand year 
very : high storm heavy few fat 
old : dog king woman trunk iron tub female castle magician war mouse 
bad : cold father 
strange : cold creature sense 
pale : cold face 
sweet : face rain fragrance 
fine : piece ship day rain 
beautiful : piece ship female description maiden 
invisible : power spirit 
magic : power lantern snail 
short : shirt description 
bright : ship day copper 
evil : day spirit 
heavy : creature heart stick 
dead : bird child 
sudden : chill breeze roll 
noble : heart mind kind 
vast : pier stretch 
brief : drizzle vision 
cool : breeze yellow 
silver : thread harp cross 
sharp : knife word 
few : feet men 
thousand : feet men 
terrible : storm affair 
wonderful : building journey fragrance 
real : king castle street war 
full : band year 
different : kind affair 
wise : woman father 
